            ################################################################################               
            #                                                                              #               
            #                                                                              #               
            #______________________________________________________________________________#               
            #                                                                              #               
            #                                                                              #               
            #                                                                              #               
#############                                                                              ################
#           #                                                                              #              #
#           #                                                                              #              #
#           #                                                                              #              #
#           #                                                                              #              #
#           #                                                                              #              #
#############                                                                              ################
            #                                                                              #               
            #                                                                              #               
            #                                                                              #               
            #______________________________________________________________________________#               
            #                                                                              #               
            #                                                                              #               
            #                                                                              #               
            ################################################################################               